#######################################################
#  #x  ######      #            ##                    #
# ###  ####    ##     #  #     ####                   #
# ####       ######   # #      ####                   #
#  #######    ####    ##       #  ##               # ##
#      ####  ###      # #      ##                  ####
#         ## #        #  #     ######            ###  #
#          # #            ##   #####    ###       #   #
#          # ##      ########   ####  #####        #  #
#          #  ##   ##    ####   # #  ########       # #
#         #  ##   ##   #   ##        ########         #
#        #  ##   #   ####           ####   ###        #
#       #  #       ###  ###         #####             #
#      ## #     ###       ##      ###     #####       #
#    #### #    #    ##### ##     ##    #######   ###  #
# #####   #  ##  ###    ###     ####  ###    #   #  # #
# ##      ##### ###  #   ##     #######          #  # #
# ##   ## ###   ##  ##  ##      ######           ##   #
# #### ##  ###  #    #####       ####            #    #
#   ######     ##      #                ###      #    #
#     #  ### ###              ###      #   #######  ###
#          ###         #     #           #  #####   ###
# ##                  ####    ##      #####  ##    ####
#####                ######     #    #######      #####
######                ###    ###     #######  #########
# ###      ###        #   ##   ###   ######  #######  #
#         ####         ############   ####  #######   #
#        #####               #######          ###     #
#         ###            ##   #####                   #
#######################################################
